3RRRRRRRRRRRRRRRRRRRRRRRRRRRR4
l0000000000000000000000000000r
l0000000000000P00000000000000r
l0000000000000000000000000000r
l0000000000000000000000000000r
l0000000000000000000000000000r
l0000000000000000000000000000r
l0000000000000000000000000000r
l0000000000000000000000000000r
l0000000000000000000000000000r
l0000000000000000000000000000r
l0000000000000000000000000000r
l0000000000000000000000000000r
l0000000000000000000000000000r
l0000000000000000000000000000r
l0000000000000000000000000000r
1ffffffffffffffffffffffffffff2